#######E#
#       #
# ### # #
# # # # #
# # ### #
#   #   #
# ##### #
#   #   #
#######S#