#####E###
# # #   #
# # # ###
# # # # #
# # # # #
# #     #
# # # # #
#   # # #
#####S###