#####E###
# #     #
# # # # #
#   # # #
# ##### #
# #     #
# ### # #
#   # # #
#######S#