#E#######
# # #   #
# # ### #
#       #
# # ### #
# #   # #
### # # #
#   # # #
###S#####